########O###O##
0####1####5###6
##O############
#####4#########
########O######
7##############
############O##
#O#############
8#############9
###############