##@#################
A---B##@############
####|########I---J##
##F-+-----E##|###|##
##|#|#####|##|###|##
#@|#|##@##|##|###|##
##G-+-----+--H###|##
####|#####|#@####|##
####C-----D##L---K##
#######@#####|##@###
####T---S####M----N#
####|###|####P----O#
#V--U###R----Q##@###
####################