########O###O##
0####1####5###6
##O############
###############
########O######
7##############
###############
#O#####O#######
8#############9
###############