##O############
0PPP1##O#######
####P########89
##5PPPPPPP4##P#
##P#P#####P##P#
##P#P##O##P##P#
##6PPPPPPPPPP7#
####P#####P#O##
####2PPPPP3####
#######O#######