########O###O##
0PPPP1PPPP5PPP6
##O###########P
PPPPP4PPPPPPPP5
P#######O######
7##############
P###########O##
PO#############
8PPPPPPPPPPPPP9
###############